#######
# A   #
# @ @o#
# o   #
#     #
#######