#######
# A   #
# @   #
# o   #
#     #
#     #
#     #
#######