  #####
  #   #
  #   #
  # @o#
###   #
#     #
#A@o  #
#######