#######
# A   #
# @   #
# o   #
#######