#######
#A    #
#     #
#@@@@@#
#ooooo#
#######