#######
#   A #
# @   #
# o   #
#######